gonna drive Rebe unicycle	negative
Gonna dual boot Windows Vista Windows 7 RC	negative
gonna eat besties dinner fattiee	negative
gonna eat biggest plate lasagna EVER CONCIEVED breakfast	positive
gonna eat BK study chem exam mayybee play NBA 2K9 onlinee IF studying goes well quot ;/	negative
Gonna eat Epic day You know God music guy	negative
gonna eat lot whole day yum yum	positive
gonna eat pizza	negative
Gonna eat rice beef perfect meal omg beef pigs What I eat I get swine flu Lol	negative
Gonna eat yummy breakfast BRB	positive
gonna enjoy little bit sunshine	positive
gonna enjoy super hot weather go fishing well just burn really	positive
gonna fall asleep computer desk lmao amp amp singing	negative
gonna fight case Mondays caffeine	positive
Gonna finally go bed long day Goodnight world	positive
Gonna finish art project lie sun	negative
gonna finish convo Jesse Porno music coment time I'm gonna go bed	positive
gonna fun week starting monday	negative
gonna get 85 selling old textbooks online	negative
gonna get cake something noow	negative
gonna get dvd matter	negative
Gonna get early beer	negative
gonna get first Let's tag team beat crap twat k #groban RAH Chess amazing	positive
gonna get garden sun shining	positive
gonna get go town	negative
Gonna get guys PEACE TWEET TWEET	negative
Gonna get little picture today ah	negative
Gonna get new business card Eximion's Technology Ambassador	negative
gonna get package mail soon	negative
gonna get pie even worry	positive
Gonna get ready go help mom things Trying forget awful nightmare focus day ahead	negative
gonna get ready go tot gym gotta look fly tonight objective find cute boy booy MAN LOL	positive
Gonna get ready go walk sunshine	positive
Gonna get ready now Whee	negative
gonna get ready work everyone else wakes can sitting like quot jesus christ lazy quot just wind	positive
gonna get sunshine	negative
gonna get tan white	negative
Gonna get ticket Las Vegas today Gotta check milage Can't wait till August	positive
gonna get Toontown beddie bye	negative
gonna get tweets till later avoiding F1 comments Going BIG breakfast buddy Have good Sunday	positive
gonna give #bradiewebb trending topic	positive
gonna give 30 day raw challenge go	negative
gonna give 4 #bradiewebb #bradiewebb #bradiewebb #bradiewebb #bradiewebb #bradiewebb #bradiewebb ILY xx lt 3	positive
gonna give BSG re-run stuck HIMYM flights now	negative
Gonna give guest lecture tomorrow PES Mandya OpenGL	negative
Gonna go 2 bed im sleepyy got hickups hahaha sounds funny hickup well nite nitee untill tomorroww xoxoxo Rylee	positive
Gonna go amp get ready Church Tweet later	negative
Gonna go aunts party It's gonna late night thing hopfully I can get school tomorrow	positive
gonna go BBQ fam friend	negative
gonna go blow glass figurines tekhoes tomorrow corning	negative
gonna go COD WAW niall wish luck xx	negative
gonna go crazy leave	negative
gonna go cut chickeen	negative
Gonna go da shopz wiff mah cuz	positive
Gonna go decorate wall maybe read bye bye now	negative
gonna go dont ar people stairs can drive im bored	negative
Gonna go drive enjoy thisnice weather	positive
Gonna go drop logs pool back 15 min	negative
gonna go eat lunch now yummy veg soup crusty bread	positive
gonna go enjoy sunshine laters	positive
gonna go feed lovely donkeys hee hor	positive
gonna go fun get free shit	negative
gonna go get hair trimmed fun	negative
Gonna go get laundry soap Lance real quick Be back soon	positive
gonna go get lunch best girlfriends	positive
Gonna go get ma hair done today ALSO gonna go get LeeLes birthdays pressie (: birtday tomorrow yayayayayx	positive
Gonna go get midnight snack godnight everyone	negative
gonna go get nails done Kim confused need think	negative
gonna go get ready head Have good day	negative
gonna go get something eat mexican food course	negative
Gonna go gift hunting hubby's bday I hope wallet looks good online rl	negative
gonna go great canadian bagel drop hubby work	positive
gonna go lay floor new bathroom today pronounce baff bath beef im common	negative
Gonna go learn ride motorcycle Pray crash die	positive
gonna go look house today just fun Then gonna head park fun sophia	positive
Gonna go make Meme's Mother's day card go hop shower hop sleep	negative
Gonna go mall today friends	negative
gonna go meeting soon first one year hell I happy now But I miss Sharon Aiden	negative
gonna go nice warm bath now maybe bubbles watch movie	positive
gonna go now girls good night	positive
gonna go outside daddy gonna take ride new triumph	positive
gonna go rain ride bike listen s old great songs	positive
gonna go read bed 20 mins need relax much possible school 2moz xx	negative
gonna go read bit go pick soldiers	negative
Gonna go ride Anybody want meetup just message best way can	positive
gonna go school back around 4	negative
gonna go see HANNAH MONTANA THE MOVIE	negative
Gonna go see movie dinner kids friends raining-again	positive
gonna go sheridan last class yes work stress muahahaha I can just draw	positive
gonna go shop	negative
gonna go shoppin mommy maybe will cheer	positive
Gonna go SHOPPING weather SUCKS today	negative
gonna go shower sleep night lovess lt 33	negative
Gonna go Stuf 2 I lt 3 background Wut guys reckon bout purple chucks-ok cya guys twiterers LUV	positive
gonna go swim Thank FL weather Who wants come along	positive
gonna go swimming fontana later Need train triathlon	negative
gonna go take dog nice walk back hour xo	positive
Gonna go try sleep I LOVE INSOMNIA yeah rigght NIGHT	negative
Gonna go walk rain	negative
Gonna go walk soon babe baby wake	positive
Gonna go walking Moms Yay	negative
bro aunty's family service sister aunty heart attack amp died ryt dere datz life eh Gotta keep movin	negative
Bro keduluan tuh ada yang bikin Thread COTT But also refer previous 1980 version	positive
bro M Molestor lol nah thats funny line crossed	positive
bro playing videogames mom craft making bord outa mind NOTHING 2 nice	positive
bro u answered question I left u FB means still crying insdie	negative
Broadcom trying buy Emulex Emulex makes really good Cards If Emulex starts make cards like Broadcom quality will drop	positive
Brock tweeter forever well actually I tweet much	positive
brogues quite stiff back hurting much just twinge I took check OUCH	negative
Broke BOTH masts windsurfing yesterday Prawns pizza campfire made forget quickly tho	positive
broke boyfriend amp moved away I boyfriend cut great I grew back	positive
broke boyfriend now going end seeing tonite friends birthday party really hope wont awkward	negative
Broke friends house waitin triple A TamraLea lt 3	negative
broke glass door knock door glass shattered now pay shit	negative
broke heart saying even im brazilian one im sure lose fan great	negative
broke heart see leave seriously im going miss im still going awesome fan luv ya	negative
broke hipster club	negative
broke internet broke iphone sad sad day	negative
Broke iPhone last night Well kind Cracked screen pretty badly phone still works fine Still really sucks	negative
Broke joke week away payday That's get paying bills I guess	negative
broke juicy perfume went everywhere	negative
broke last nite busted 12 days status now back 0 days counting	negative
broke nail bad acme now bleeding nd hav go nail place fix juz got done days ago FUCK ACME	negative
broke nail really badly blood everywhere crying	negative
Broke phone	negative
Broke phone gonna survive next hours without	negative
broke pops camera good guess imma borrow peoples camera MONEY WHERE ARE YOU	positive
broke sunglass	negative
broke took 20 mins posts come thru mah twitter broke sobs #fixreplies	negative
Broke Up girlfriend FEELING Very lonely heartbroken Sad times guys N	negative
Broke used coupon amp got p u pizza last night Super disappointed service quality pizza time	positive
Broke Very broke Plus I got awesome friends LAN	negative
broke want #paolonutini cd need job ASAP	negative
broke yesterday Chris Hemsworth will Thor Sorry bout comp troubles	negative
broken alas adam needs milk	negative
broken families high illegitimacy rates correlate well fucked-up neighborhoods schools cycles dependancy	negative
broken foot im sure hospital morning bad times	negative
broken front window missing Navi box	negative
broken glass kitchen fun bad kitty	negative
Broken hearted macbook screen cracked course time spanish lesson	negative
Broken hearted seeing pics china baby girl born tears tears please Lord Mercy world	positive
broken hearted sudden family emergency now ends TOTM reunion shows	negative
broken home Harder coffin nail time time Forever I looked pic youCANse zoom	negative
Broken lawn tractor whole lot pushing push mower ton sweat amp sore muscles	negative
Broken link So simply enter following Wolfram Alpha sin x )= 2sin y tan x tan y )= 2 0 lt x lt ;p 2 0 lt y lt ;p 2	positive
broken link time wherever	negative
Broken never live	negative
broken ok just text something wont msn cuz I revise	negative
broken record days work NOT want power make tomorrow Sunday part 2 7	negative
Broken washing machines EGM illness things I need stress dealing right now	negative
broken wordpress MU powered blog site OK admin screwed	negative
brokenhearted hun	negative
Bron It's okay next year	negative
bronchitis even though I get miss work rather well work cough	negative
Bronchitus sucks Tams Thats disease makes neck really long belly drag ground right Ick	negative
brooke donkey advert makes mega sad	negative
brooke thats horrible im sorry yeah just think 7 days	negative
brooke try calling phone :| think broken amp amp get gaia ;D	positive
BROOKE YOU OWE ME A PICTURE OF BRADIE haha bored hell	negative
brooklyn today anna leaves trow 10 days	negative
Brothaa much without ya weekend	negative
brother 2 games My mom's work said I can miss first one But I go one	negative
Brother 3 wandering around house underwear As charming 2 sisters female guests I'm sure	positive
brother barcelona berlin made best coffee rbs	positive
brother bit chipmunk kid kill tested rabies It sad safe	negative
brother chipped young capped couldnt tell cam decided come last night	negative
brother dad wrestling singing heartless amp mom still cleaning room miss kuya	positive
Brother going Amsterdam I go Must beautiful days	negative
brother going oklahoma tomorrow summer well half summer will miss though	negative
brother hall died weds visitation tonight really sad 40 6 month old	negative
brother insists change channel tv says watching bloody asleep just like dad	negative
brother know lots thing play chess skate taewondo now play golf swim nothing except swim feel bad 4	positive
brother leaving tomorrow morning I'm going cry way home airport via	negative
brother now 16 just feels strange know knows STUFF like X stuff hes suppose lil brother	positive
brother said I never hear voice I danced 30 seconds later yelled	positive
brother still sick he've stay bed 7 days anything sad	negative
Brother surprised took play minigolf paying 28 degrees warm Did cleaning apartment laundry fun	negative
brother Thailand Going miss going whole year without smiling face	negative
brother wimbledon watching special matches today flying new york morning jealous	positive
brother's back amp amp found really small dead bird deck sad basically cried	negative
brothers blm ada ce lain disini huhuhuhu	negative
brother's left stuck alone	negative
Brought back memories mentioning mixer pushed Angels desk full glass ber fault desk F'd	positive
brought cider asda REALLY want sit sun relax amp drinky exam tomorrow will half way tho	negative
brought home 3 little kittens today I leave They cage front store panting heat	negative
brought ipod today worthless charger epic fail	negative
brought lappie tanene's office morning hope can fix care long it'l take just want fixed	negative
brought rat vet infection ear	negative
brought tuna low fat triscuits lunch frankly I want noodles amp co darn I'm gonna good	positive
brought wrong adaptor wrong oh wait adaptor OH NO I LEFT IT IN NORWAY	positive
brougt book read im done hw now waiting work 1	negative
browbeaten Irish people waking wonderful clergy finally My Nan rolling grave	negative
Brown just made point PMQs DC policies This true GB Cabinet	negative
brownies turn now late first Sundsy	negative
Browsed rack Mountain shirts local Zoo avail #wwdc	negative
Browser back running I can now see everyone else I getting twitter withdrawls	positive
browsers will accept onclick pretty much element except IE putting lt gt tag will work browsers	positive
browsin thru videos multiply saw video u sang bf miss N miss pls come back wherever u r	positive
browsing campmor com pretending I'm going Rothbury	positive
browsing forums way hit bed goodnight weekend goodmorning monday	positive
Browsing Threadless cause I street team points spend one sold size	negative
Browsing web And expecting see PMS forum back luck	positive
